Size: 3

p0 , (0 , 0)
e0 , (0 , 1)
p1 , (0 , 2)
e0 , (1 , 2)
e0 , (2 , 2)