Size: 4

p0 , (0 , 0)
p2 , (2 , 0)
e0 , (0 , 3)
e0 , (1 , 3)
e0 , (2 , 3)
e0 , (3 , 3)