Size: 5

p1 , (1 , 1)

e0 , (0 , 4)
e0 , (1 , 4)
e0 , (2 , 4)
e0 , (3 , 4)

e2 , (4 , 0)
e2 , (4 , 1)
e2 , (4 , 2)
e2 , (4 , 3)
e2 , (4 , 4)